1111111111111111
1111111110ECP111
1111111111111111
