111111
11P0C1
100111
11E111
111111