11111111111
1EPCM0M0001
10000000001
10000000001
10000011001
11111111111
