111111
1100C1
1P0111
11E111
111111