111111
1100C1
10P111
11E111
111111