11111111111
1E1C0000001
10000000001
1P0000000M1
10000011001
11111111111