1111111111111111
1E1CM00000111111
1000000000111111
1P00000000111111
1000001100111111
1111111111111111
