11111111111
1100000C001
1000P100C01
100EM100011
11111111111