11111111
1100C001
10P100C1
11E1M111
11111111