11111111111
1E1CM000001
10000000001
1P000000001
10000011001
11111111111
